#######
#.....#
#...+.#
##..+.#
#--.#P#
#######
